Patch=修補
[Event]=[活動]
[Expansion]=[擴充]
Public =公開
Testing=測試
Release=發布
What's New in the Combat Update=戰鬥更新內容概覽
Update=更新
Future Upd Ann=未來更新公告
Future Update Announcement=未來更新公告
Future Update is starting Development=未來更新正開始開發
Releasing before Combat Update=在戰鬥更新之前發布
Rose for All Races=所有種族皆可使用桃紅型態
Rose Equiv Form for All Races=所有種族的桃紅對等型態
Potara Fusion=波塔拉耳環融合
Cross Race Fusion=跨種族融合
Stat Cap Raise=屬性上限提升
and More to be Announced=以及更多待公告的內容
Cell Saga PQ (New Armor)=賽魯篇 平行任務[PQ] (新盔甲)
A bunch of Misc Fixes=一堆雜項修正
Fusion Bug Fixes=融合錯誤修正
New Cosmetic Toggles for some Forms=部分型態的新外觀開關
Fixed a Memory Leak on the Main Menu=修復主選單的記憶體洩漏問題
Update is out, Change-Log will be released in due time=更新已推出, 更新日誌將於稍後發布
Trailer for 1.2.7=1.2.7 版本預告片
Where's the 1.2.7 Update at?=1.2.7 更新在哪裡?
We're having a Public Alpha Test for the Combat Update, check it out!=我們正為戰鬥更新進行公開 Alpha 測試, 快來看看吧!
Update & Patches=更新與修補
Dev Blog=開發日誌
Dev log=開發日誌
, Combat =, 戰鬥
Legendary Super Saiyan=傳說賽亞人
Character Creation Stat Loss Fix=角色創建屬性遺失修正
Potential Server Wide Transformation Fix=伺服器全域變身潛在修正
General Fixes & CleanUp=一般修復與清理
General Fixes=一般修復
New Server Restart System=新的伺服器重啟系統
Playtime System Polish=遊玩時間系統優化
Quick Selection Fixes=快速選擇修正
New "Context" Menu=新增 "右鍵功能" 選單
Shift Stack Consumption=Shift 堆疊消耗
Character Slot Selection Screen=角色欄位選擇介面
Tons of Misc Changes & Fixes=大量雜項更動與修正
Challenger Luck Boost=挑戰者幸運加成
OnTime replacement=取代 OnTime
OnTime Replacement=取代 OnTime
Playtime System=遊玩時間系統
Gear Coin Drop Changes=裝備幣掉落更動
Quick Selection Changes=快速選擇更動
First Person Hand Fix=第一人稱手部修正
Packet Fixes=封包修正
Added this Interface Element=新增此介面元素
Vanity Outfit ReTextures=虛榮服裝材質重製
Fusion Fixes=融合修正
Global Chest Fixes=跨服箱修正
Mastery EXP Loss Fixed=精通經驗值流失修正
Character Slot Bug Fixes=角色欄位錯誤修正
Database Optimization=資料庫最佳化
Movie Pack=劇場版合集
Racial States=種族狀態
Character Creation=角色創建
(Required)=(必要)
Fix for Character Creation Stat Loss=修復創建角色時的屬性點流失
Quick Selection=快速選擇
Much More=以及更多內容
Melee Heavy Hits & Shoulder Camera=近戰重擊與肩膀視角
DBZ Style Ki Blasts in Minecraft=Minecraft 中的七龍珠風格氣功波
DBZ Style Combat in Minecraft=Minecraft 中的七龍珠風格戰鬥
What happens when Ki Attacks Explode?=當氣功攻擊爆炸時會發生什麼事?
Special Beam Cannon in Minecraft=Minecraft 中的魔貫光殺炮
Huge Changes to Melee Combat in Minecraft=Minecraft 中近戰格鬥的巨大變化
Future Super Saga Announcement=未來超篇章公告
Combat Alpha Testing Starts NOW=戰鬥 Alpha 測試現在開始
Animated NPCs Are Finally Here in Dragon Block Apollo!=動畫 NPC 終於來到 Dragon Block Apollo!
This Skill Tree Will Change Everything! Dragon Block Apollo=這個技能樹將改變一切! Dragon Block Apollo
Checkout this Getting Started Guide!=快來看看這份新手入門指南!
Stat Proposal v2, A Refined Take=屬性提案 v2, 更完善的方案
Video How To / Guides=影片操作指南
Combat Demo=戰鬥演示
Winterween=冬令萬聖節
SpookFest=萬聖節
Spook =萬聖節
Spook Fest=萬聖節
Check the News Menu or Discord for details!=查看新聞選單或 Discord 獲取詳情!
Candy Jack-o-Pot=糖果大獎罐
Challengers (1s-6s)=挑戰者 (1階-6階)
Crate=寶箱
Sky Boxes=天空背景貼圖
Over 20 Unique across every Location=每個地點總計超過 20 種獨特內容
Global Chat=跨服聊天
New Player List=新玩家列表
Quick Selection Fast Ascend=快速選擇的快速變身
Bank Shift Click=銀行 Shift 點擊
CC Gradient Hairs=CC 漸層髮型
Recovery Item Restock Button=恢復道具補貨按鈕
New Mall Stores (Namek, Rocky, Nether)=新商城店鋪 (那美克星、岩石區、地獄)
New Mall Stores (Namek, Rocky, and Nether)=新商城店鋪 (那美克星、岩石區以及地獄)
Cross-Server Ender Chest & Crates Rework=跨服箱與寶箱系統重製
Form Souls & Kaio Shards=型態靈魂跟界王拳碎片
, and Spook Particles=以及萬聖節粒子效果
, and Jolly Particles=以及聖誕節粒子效果
DBZ Ki Disk & New Ki Coloring=七龍珠 Z 氣功圓盤與新氣功配色
DBZ Kamehameha Wave in Minecraft=在 Minecraft 中的七龍珠 Z 龜派氣功
New Body Sizes, Breasts, & Hair=新體型、胸部與髮型
Perks=特權
Whis & Primal Training Changes - Feature Highlight=維斯與原始修行變更 - 特色亮點
Rank Returns=階級回歸
Daily Missions Bonus=每日任務加成
5 Year Anv=五週年紀念
5 Year Anniversary=五週年紀念
4 Year Anniversary=四週年紀念
3 Year Anniversary=三週年紀念
5 Year Title=五週年紀念稱號
4 Year Anv Title=四周年紀念稱號
Remaster 5th Year Anniversary=重製版五週年紀念
Remaster 5 Year Anniversary=重製版五週年紀念
(Event)=(活動)
(Video)=(影片)
(Rerun)=(回歸)
(Teaser)=(預告)
Event GiftBox=活動禮包
 Store Sale= 商店特賣
 TP Booster= TP 加成
 TP Boost= TP 加成
 EXP Boost= 經驗加成
Jolly=聖誕節
Event=活動
Return of 6 old Event Cosmetics=回歸 6 件舊活動飾品
Unique Cosmetics=獨特飾品
Present Drops=禮物掉落
Gift Box=禮物盒
Cosmetic T-Shirts=T恤飾品
I made a DBZ Ki Attack Creator=我製作了一個七龍珠 Z 氣功攻擊創造器
DBZ Ki Attack Creation & Spirit Bomb=七龍珠 Z 氣功攻擊創作與元氣彈
Also from Jolly Rank=同樣來自聖誕階級
Stars of =星
 Challengers= 挑戰者
Challengers=挑戰者
Explosions, Dynamic Lights, and Combat=爆炸、動態光影與戰鬥
Sunglasses Cosmetic=太陽眼鏡外觀飾品
Summer Shirt & Pants=夏季襯衫與褲子
All Cosmetics Available at "summer time lil" in Spawn=所有外觀飾品皆可在重生點的 "夏日活動的 lil" 處取得
Changes to Metamoran Fusion & Party Questing=梅達摩融合與組隊任務的變更
Summer Festival=夏日慶典
Spring Festival=春日慶典
The Revival Festival=重生慶典
Anniversary =週年紀念
Anniversary=週年紀念
Weekly Kit=每週禮包
Coin Drops=金幣掉落
GiftBox=禮物盒
Crown Cosmetic=皇冠外觀
Also Summer Stuff is available!=還有夏季物品開放!
Summer 2025 Title=2025 夏日稱號
Summer 2024 Title=2024 夏日稱號
Summer Sunglasses, Summer Shirt, and Summer Pants=夏日太陽眼鏡、夏日上衣、以及夏日長褲
(Zeni Trades)=(使用賽尼購買)
Combos, Finishers, and Heavy Hits in Minecraft=在 Minecraft 中加入連擊、終結技與重擊
We need your help, Recruiting Team Members=我們需要你的幫助, 招募團隊成員
Combat Update is the next Update=戰鬥更新即將登場
Entering Public Alpha Testing Soon!=即將開啟公開 Alpha 測試!
Egg Hunt=彩蛋尋寶
Egg Shop=彩蛋商店
Easter=復活節
thankgiving=感恩節
Valentines=情人節
Valentines System=情人節系統
Valentines Shop=情人節商店
All New Valentines T-Shirt=全新情人節 T 恤
All new Valentines Particles=全新情人節粒子特效
Revival of Frieza=復活的F
Universe 6=第六宇宙
Universe 6 vs. 7=第六宇宙 vs 第七宇宙
Battle of Gods=神與神
Remaster =重製版
BDay Event=生日活動
lil's Birthday celebration=lil 的生日慶祝活動
BoG Celebration=神與神慶典
Easter Egg Shop Refresh=復活節彩蛋商店商品更新
Daily Mission Bonus=每日任務獎勵
Easter 2025 Title=2025 復活節稱號
Easter Ears / Mouth=復活節耳朵 / 嘴巴
Easter T-Shirt & Mask=復活節 T 恤與面具
New Cosmetic T-Shirt=新T恤飾品 
Bunny Mask, Ears, and Mouth Cosmetics=兔子面具、耳朵與嘴巴外觀飾品
A Wild Change to Server Allocation and Performance=伺服器調配與效能的重大變革
Maintenance will commence on=維護將於
, follow Discord for details=, 詳情請關注 Discord
Easter Particles=復活節粒子特效
Easy Warping, Title Changing, Rank Display Changing, and Cosmetic Toggling=輕鬆傳送、更換稱號、變更階級顯示與切換外觀
Full Change-Log can be found here=完整的更新日誌請見此處
The End of the Dragon Ball Z Story=七龍珠 Z 故事的結局
Metal Final Form?! Why does Buu have so many forms?=金屬最終形態?! 為什麼普烏有這麼多形態?
Challenging Majin Buu, My Final Form?!=挑戰魔人普烏, 我的最終形態?!
Buu Saga in Dragon Block Apollo=在 Dragon Block Apollo 的普烏篇
New Blocking & Parrying in Minecraft=在 Minecraft 中加入格擋與招架
Bibidi Babidi Buu in Dragon Block Apollo=比比迪、巴比迪與普烏在 Dragon Block Apollo
Stat Change Proposal, no longer using DBC Stats=屬性更動提案, 不再使用 DBC 屬性
Melee Combat Animations in Minecraft=Minecraft 中的近戰格鬥動畫
Animated Combat & Character=動畫戰鬥與角色
Animated Ki Wave Firing=動畫氣功波發射
Facing Off Against Cell in Dragon Block Apollo=在 Dragon Block Apollo 中對抗賽魯
How to Unlock & Use LSSJ / Racial States on Dragon Block Apollo=如何在 Dragon Block Apollo 中解鎖並使用 LSSJ / 種族狀態
Ki Wave Firing=氣功波發射
Where is Goku? What's a Cell?=悟空在哪裡? 賽魯是什麼?
Reincarnated, Back to=轉生, 回到
New Ki Wave Clashing=新的氣功波對波
Frieza’s Downfall and The Rise of Robotic Terror=弗利沙的隕落與機械恐怖的崛起
Z Vanish Combat in Minecraft=Minecraft 中的 Z 瞬間移動戰鬥
Instance=伺服器
New York, US=美國, 紐約
Dallas, US=美國, 達拉斯
Los Angeles, US=美國, 洛杉磯
Frankfurt, DE=德國, 法蘭克福
London, UK=英國, 倫敦
Sydney, AU=澳洲, 雪梨
